XXXXXXXXXXXXXXXXXXXXXXXXXXXXXXXXXXXXXXXXXXXXXXXXXXXXXXXXXXXXXXXXXXXXXX
X   XXXXXXXXX                                  XXXXXX        XXXXXXXXX
XXX           XXXXXXXXXXXX XXXXXXX XXXXXXXXXX XXXXXXX   XXXX XXXXXXXXX
XXXXXXXXXX XXXXX       XXX XX XXXX XXXXXXXXXX XXXXXXXX  XXXX XXXXXXXXX
X        X XXXXX XXXXXXXXX XX XXXX XXXXXXXXXX XXXXXXXXX XXXX XXXXXXXXX
X XXXXXX   XXXX            XX XXXX XXXXXXXXXX                   XXXXXX
X XXXXXXXXXXXXX  XXXXXXXXXXXX XXXX XXXXXXXXXXXXXX XXXXXXXXXXXXX XXXXXX
X X    XXXXXXXX XXXXXXXXXXXXX XXXX     XXXXXXXXXX XXXXXXXXXXXXX XXXXXX
X XXXX XX X XXX XXXXXXX       XXXX XXXXXXXXXXXXXX XXXXXXXXXXXXX XXXXXX
X         X    X        XXXXXXXXXX  XXXXXXXXXXXXX XXXXXXXXXXXXX XXXXXX
XXXXXXXXXXX   XXXXXXXXXXXXXXXXXXXXXXXXXXXXXXXXXXX XXXXXXXXXXXXX XXXXXX
XXXXX         X                      XXXXXXXXXXXX XXXXXXXXXXXXXXXXXXXX
XXXXXXXXXX  X XXXXXXXXXXXXXXXXXXXXXX                            XX   X
XXXXXXX    XX    XX   X   XX   X     XXXXXXXXXXXXXXXXXXXXXXXXXX XX X C
XXXXXXX XXX XXXX    X   X    X   XXXXXXXXXXXXXXXXXXXXXXXXXXXXXX XX XXX
XXXXXXX XXX XXXXXXXXXXXXXXXXXXXXXXXX XXXXXXXXXXXXXXXXXXXXXXXXXXXXX XXX
X                 XXXXXXXXXXXXXXXXXX                      XXXXX    XXX
X XXXXXXXXXXXXXXXXXXXXXXXXXXXXXXXXX XXXXXXXXXXX XXXXXXXXX XXXXX XX XXX
X                                               XXXXXXXXX           XX
XXXXXXXXXXXXXXXXXXXXXXXXXXXXXXXXXXXXXXXXXXXXXXXXXXXXXXXXXXXXXXXXXXXXXX
