XXXXXXXXXXXXXXXXXXXXXXXXXXXXXXXXXXXXXXXXXXXXXXXXXXXXXXXXXXXXXXXXXXXXXX
X   XXXXXXXXX                                  XXXXXX        XXXXXXXXX
XXX           XXXXXXXXXXXX XX XXXX XXXXXXXXXX XXXXXXX   XXXX XXXXXXXXX
XXXXXXXXXX XXXXX       XXX XX XXXX XXXXXXXXXX XXXXXXXX  XXXX XXXXXXXXX
X        X XXXXX XXXXXXXXX XX XXXX XXXXXXXXXX XXXXXXXXX XXXX XXXXXXXXX
X XXXXXX   XXXX            XX XXXX XXXXXXXXXX                   XXXXXX
X XXXXXXXXXXXXX  XXXXXXXXXXXX XXXX XXXXXXXXXXXXXX XXXXXXXXXXXXX XXXXXX
X X    XXXXXXXX XXXXXXXXXXXXX XXXX     XXXXXXXXXX XXXXXXXXXXXXX XXXXXX
X XXXX XX   XXX XXXXXXX       XXXX XXXXXXXXXXXXXX XXXXXXXXXXXXX XXXXXX
X         X             XXXXXXXXXX  XXXXXXXXXXXXX XXXXXXXXXXXXX XXXXXX
XXXXXXXXXXXXXXXXXXXXXXXXXXXXXXXXXXXXXXXXXXXXXXXXX XXXXXXXXXXXXX XXXXXX
XXXXX                                XXXXXXXXXXXX XXXXXXXXXXXXX XXXXXX
XXXXXXXXXXX XXXXXXXXXXXXXXXXXXXXXXXX                            XX   X
XXXXXXXXXXX XXXXXXXXXXXXXXXXXXXXXXXX XXXXXXXXXXXXXXXXXXXXXXXXXX XX X C
XXXXXXXXXXX XXXXXXXXXXXXXXXXXXXXXXXX XXXXXXXXXXXXXXXXXXXXXXXXXX XX XXX
XXXXXXXXXXX XXXXXXXXXXXXXXXXXXXXXXXX XXXXXXXXXXXXXXXXXXXXXXXXXX XX XXX
X                                                         XXXXX    XXX
X XXXXXXXXXXXXXXXXXXXXXXXXXXXXXXXXX XXXXXXXXXXXXXXXXXXXXX XXXXX XX XXX
X                                   XXXXXXXXXXXXXXXXXXXXX           XX
XXXXXXXXXXXXXXXXXXXXXXXXXXXXXXXXXXXXXXXXXXXXXXXXXXXXXXXXXXXXXXXXXXXXXX


